EA ./textures/colorstone.xpm
SO ./textures/greystone.xpm
NO ./textures/redbrick.xpm
WE ./textures/wood.xpm

F 124,142,12
C 12,220,125

1111111111
1000000001
1111000001
1000000001
100N001001
1010001011
1000001001
1111111111