EA ./path_to_the_east_texture
NO ./path_to_the_north_texture
SO ./path_to_the_south_textures

WE ./path_to_the_west_texture

F 1,2,250
C 225,30,0

11111111111111111111111111111
10100000000000000000000000001
10000000000100000000000000001
10000000000000000000000000001
10000010000000000000000000001
10000000000000000000000000001
10000000000000000000000000001
10000000000000001000000000001
10000N00000000000000000000001
10000000000000000000000000001
10000000000000000000000000001
10000000000000000000000000001
10000000000000000000000000001
10000000000000000000000000001
10000000000000000000000000001
10000000000000000000000000001
10000000000000000000000000001
10000000000000000000000000001
11111111111111111111111111111
