EA ./textures/bluestone.xpm
NO ./textures/redbrick.xpm
SO ./textures/colorstone.xpm
WE ./textures/test.xpm

F 255,255,153
C 0,128,255


11111111111111111111111111111
10000000000000000000000000001  
10000000100000000000000000001  
10101000000000000000000000001  
100000000000000000000000S0001  
10000000000000000000000000001  
10101000010001000000100000001  
10101000000000000000000000001  
10101000000000000000000000001  
10101011100000000000000000001  
1011101 100000000000000000001
10000011100000001110011100001  
10000000000000000000000000001  
10000000000000000000000000001  
10000000000000000000000000001  
10000000000000000000000000001  
10000000100000000000000000001  
11111000000000000000001111111  
    1111111111111111111
