EA ./textures/bluestone.xpm
NO ./textures/redbrick.xpm
SO ./textures/colorstone.xpm
WE ./textures/test.xpm

F 1,2,250
C 225,30,0

11111111111111111111111111111
1E000000000000000000000000001
10000000000000000000000000001
10101000000000000000000000001
10000000000000000000000000001
10000000000000000000000000001
10101000010001000000000000001
10101000000000000000000000001
10101000000000000000000000001
10101000000000000000000000001
10111000000000000000000000001
10000000000000001110011100001
10000000000000000000000000001
10000000000000000000000000001
10000000000000000000000000001
10000000000000000000000000001
10000000000000000000000000001
10000000000000000000000000001
11111111111111111111111111111
