EA ./textures/bluestone.xpm
NO ./textures/redbrick.xpm
SO ./textures/colorstone.xpm
WE ./textures/test.xpm

F 200,200,200
C 100,149,237

11111111111111111111111111111
1 000000000000 00000000000001
1000E000000000000000000000001
101010000000000000000 0000001
10000000 00000000000000000001
10000000000000000000000000001
10101000010001000000000000001
10101000000000000000000000001
10101000000000000000000000001
10101000000000000000000000001
10111000000000000000000000001
10000000000000001110011100001
10000000000000000000000000001
10000000000000000000000000001
10000000000000000000000000001
10000000000000000000000000001
10000000000000000000000000001
10000000000000000000000000001
11111111111111111111111111111
