EA ./path_to_the_east_texture
NO ./path_to_the_north_texture
SO ./path_to_the_south_textures
WE ./path_to_the_west_texture

F 1,2,250
C 225,30,0

11111111111111111111111111111
10000000000000 00000000000001
10000000000000000000000000001
101N10000000000000000 0000001
10000000 00000000000000000001
10000000000000000000000000001
10101000010001000000000000001
10101000000000000000000000001
10101000000000000000000000001
10101000000000000000000000001
10111000000000000000000000001
10000000000000000000000000001
10000000000000000000000000001
10000000000000000000000000001
10000000000000000000000000001
10000000000000000000000000001
10000000000000000000000000001
10000000000000000000000000001
11111111111111111111111111111
