EA ./textures/colorstone.xpm
SO ./textures/greystone.xpm
NO ./textures/redbrick.xpm
WE ./textures/wood.xpm

F 117,142,79
C 135,245,251

1111111111
1000000001
1111000001
1000004001
100N001001
1010001011
1000001001
1111111111